ZAYN - LIKE I WOULD
Ariana Grande - Dangerous Woman
Willa - Swan
Frances - Don't Worry About Me
Gwen Stefani - Misery
Seeb - Breathe feat. Neev
Kiiara - Feels (Jai Wolf Remix)
Luna Shadows - Hallelujah California
The 1975 - Nana
Joywave - Life in a Bubble | Blew
TOTEM - Addicted
AURORA - Warrior
Mako - Smoke Filled Room (Acoustic)
Matt Gresham - Small Voices
Soft Lit - U Up
Bear Hands - Marathon Man
A Day to Remember - Paranoia
Brian Fallon - Nobody Wins
Cardiknox - Souvenirs
RKCB - Open Arms feat. Demo Taped
Years & Years - Desire
Daniel Ellsworth & The Great Lakes - Always/Never
Weezer - California Kids
Them Swoops - Alright for Me
The Joy Formidable - Liana
LANY - WHERE THE HELL ARE MY FRIENDS
Sir Was - A Minor Life
Lonely the Brave - Radar
The Wild Feathers - Lonely is a Lifetime
Towkio - Gant With Me feat. Vic Mensa
Lizzo - Good as Hell
Cedric Gervais - With You feat. Jack Wilby
Martin Garrix - Now That I've Found You feat. John & Michel
Popcaan - Wicked Man Ting
Domo Genesis - Dapper feat. Anderson .Paak
Gallant - Weight in Gold feat. Seal
Tunji Ige - War
Mating Ritual - Cold feat. Lizzy Land
Lucius - Dusty Trails
Brett Dennen - What's the Secret?
Sara Hartman - Two Feet Off the Ground
Satchmode - Undertow
Tourist - Run
Darrein Safron - Bad Girl
Pegboard Nerds - Bass Charmer feat. JFMEE
Calum Scott - Dancing On My Own
BRONCHO - Fantasy Boys
Mt. Si - Oh
Tessa Rae - Seventeen
Autograf - Slow Burn