Logic - Wassup feat. Big Sean
Lil Yachty - 66 feat. Trippie Red
FLETCHER - I Believe You
Loote - Your Side Of The Bed
JP Saxe - The Few Things
Jeremih - Forever I'm Ready
Years & Years - Sanctify
James Bay - Pink Lemonade
Alison Wonderland - No
ZHU & Tame Impala - My Life
Marshmello - Fly feat. Leah Culver
Wifisfuneral - 25 Lighters
John Newman - Fire In Me
Johnny Yukon - Lonely
REMMI - Minimum Wage
Sia - Magic
Yoke Lore - Fake You
KYLE - To The Moon
Calpurnia - City Boy
Billie Eilish - MyBoi (TroyBoi Remix)
Buddy - Black feat. A$AP Ferg
Yoshi Flower - Movies
Calum Scott - Give Me Something
Sjowgren - Beginners
The Neighbourhood - Flowers
YFN Lucci - Come with Me feat. Dreezy
Maluma - El Pr√©stamo
St. Vincent - New York (DJDS Version)
What So Not & Skrillex - Goh feat. KLP
Barns Courtney - Sinners
Brett Castro - Much About Sadness
Lorde - Supercut (El-P Remix) feat. Run The Jewels
Jordan Hollywood - Cash Out
Vince Staples - Get The Fuck Off My Dick
Louis The Child - Shake Something feat. Joey Purp
Parquet Courts - Wide Awake
Wet - There's a Reason
Morgxn - translucent
Jason Derulo - Colors
Liv Dawson - Talk
Luke Combs - Dive (Recorded At Sound Stage Nashville)
YoungBoy Never Broke Again - Traumatized feat. Stitches
KILLY - No Sad No Bad
Pouya - Don't Bang My Line feat. Night Lovell
Dermot Kennedy - Young & Free
Moose Blood - Can We Stay Like This
Teenage Wrist - Waitress
Jon Hopkins - Emerald Rush
Beach House - Dive
Phora - Boss Up
TRACES - Before I Wilt
Spazz Cardigan - Episode
Mr. Probz - Space For Two
DROELOE - Many Words
CXLOE - Monster
Ciaran Lavery - 13
Necklace - Easy
Elohim - Panic Attacks feat. Yoshi Flower
Morgan Wallen - Little Rain
George Ezra - Hold My Girl
Prelow - Super Cool
Tim Atlas - Figure A
Sea Girls - Eat Me Whole
CASS - Do You (Jaisua Remix)
Sango - Khlorine feat. Smino
Trill Sammy - Do Not Disturb
Allan Rayman - God Is A Woman (Recorded At Spotify Studios NYC)
Ashley Monroe - Paying Attention
17 Memphis - Three Coors & The Truth
Shaylen - Take It Back
Salt Cathedral - No Love
Apollo LTD - Man That I Used To Know
Thirdstory - On And On
Flyte - Moon Unit
Instupendo - Fleur feat. Teen Daze