Carly Rae Jepsen - I Really Like You
Kanye West - All Day (ft. Theophilus London, Allan Kingdom, and Paul McCartney)
Jack Ü - Where Are Ü Now (ft. Justin Bieber)
Deorro x Chris Brown - Five More Hours
Cashmere Cat - Adore (ft. Ariana Grande)
Rixton - We All Want the Same Thing
Flo Rida - Once In A Lifetime
Kelly Clarkson - Run Run Run (ft. John Legend)
Wale - The Matrimony (ft. Usher)
Action Bronson - Baby Blue (ft. Chance the Rapper)
High Rule - Touch
ISHi - Push It (ft. Pusha T)
Major Lazer - Lean On (ft. MØ and DJ Snake)
My Morning Jacket - Big Decisions
Purity Ring - heartsigh
AWOLNATION - Windows
Alabama Shakes - Gimme All Your Love
Modest Mouse - Of Course We Know
Northern Faces - Cops Come
George Maple - Where You End And I Begin
PANG! - Touch (Original Mix)
Will Butler - Witness
Best Coast - California Nights
Kelly Clarkson - Invincible
Meg Mac - Roll Up Your Sleeves
Drenge - We Can Do What We Want
Odessa - Grow
Jake McMullen - If I Go
Mighty Oaks - Seven Days
Cam - Half Broke Heart
Van Morrison - Some Peace of Mind
Meghan Trainor - Don't Stop (5 Seconds of Summer Cover)
Toro Y Moi - Buffalo
Prince Royce - My Angel
Jack Ü - To Ü (ft. AlunaGeorge)
Brodinski - On Me (ft. Bricc Baby Shitro)
Above & Beyond - All Over The World (ft. Alex Vargas) (Hudson Mohawke Remix)
Oh Wonder - Technicolor Beat
Chromatics - Just Like You
Chelsea Lankes - Too Young to Fall in Love
Kita Klane - Fingerprints
Handsome Ghost - Steps
Made Violent - Wasted Days
Howard - Religion
The Woodlands - Beating Hearts Ablaze
Robyn Sherwell - Tightropes
Lena Fayre - This World