B.o.B - Not For Long (feat. Trey Songz)
Grace Mitchell - Broken Over You
Logic - Buried Alive
Jessie J - Sweet Talker
Foo Fighters - Something From Nothing
Cedric Gervais - Through the Night (Radio Edit)
Little May - Boardwalks
Priory - Put 'Em Up
Little Big Town - Quit Breaking Up With Me
Peking Duk - High
Kiesza - Losin' My Mind
SOAK - B a noBody
Waters - Over It
Florida Georgia Line - Smile
The Swon Brothers - Pretty Beautiful
We Were Promised Jetpacks - Peaks and Troughs
Big K.R.I.T. - Cadillactica
Avivaa - Crystaleyes
Andrew McMahon in the Wilderness - See Her On The Weekend
Sixx:A.M. - Gotta Get It Right
Etnik - Unclassified (feat. Mykki Blanco)
Josef Salvat - Open Season
Stars - Trap Door
Emile Haynie - Falling Apart
Mariachi El Bronx - Wildfires
AlunaGeorge - Supernatural
Elliphant - Purple Light
Foxygen - Coulda Been My Love
Wild Party - OutRight
Lucius - Until We Get There
U2 - Sleep Like A Baby Tonight
Jessie J - You Don't Really Know Me
Kindness - Who Do You Love? Feat. Robyn
OK Go - Turn up the Radio
Frazey Ford - September Fields
The Lone Bellow - Then Came the Morning
You+Me - Unbeliever
Estelle - Silly Girls
Dillon Francis - Set Me Free
The 2 Bears - Not This Time
Mackintosh Braun - The City Below
The Bots - All I Really Want
Mexico City Blondes - Colors
Birthday Boy - The Greatest Party
Emile Haynie - A Kiss Goodbye
Kele - Silver and Gold
Hoodie Allen - Numbers
Field Report - Decision Day
Wampire - Wizard Staff
The New Basement Tapes - Spanish Mary
Fyfe - Holding On
Maxine Ashley - Perpetual Nights
Cedric Gervais - Love Again
Fall Out Boy - Immortals - From "Big Hero 6‚Äù
Guster - Never Coming Down
The Doobie Brothers - Listen to the Music - with Blake Shelton and Hunter Hayes on Guitar