The Weeknd - Heartless
The Weeknd - Blinding Lights
Roddy Ricch - Tip Toe (feat. A Boogie Wit da Hoodie)
Ozuna - Fantasía
Kacey Musgraves - Glittery (From The Kacey Musgraves Christmas Show)
Godfather of Harlem - On the Inside (feat. 21 Savage)
Yung Gravy - iunno
Grimes - My Name is Dark - Art Mix
Bombay Bicycle Club - Everything Else Has Gone Wrong
Louis Tomlinson - Don't Let It Break Your Heart - Single Edit
Fuse ODG - Lazy Day (feat. Danny Ocean)
City Girls - You Tried It
Koffee - W (feat. Gunna)
No Rome - Trust3000 (feat. Dijon)
LAUNDRY DAY - CRÈME
AWOLNATION - California Halo Blue
Dimelo Flow - La Isla (with Sech & Dalex feat. Justin Quiles, La Exce, Feid, Zion)
Ally Brooke - No Good
Fabolous - Us vs. The World (feat. Chris Brown & Teyana Taylor)
Jacob Collier - Time Alone With You (feat. Daniel Caesar)
Dounia - My Own Company
Don Diablo - Congratulations
The Game - The Code
Poo Bear - Yes Please
Grady - when you're lonely
Kota Banks - Feel Again
Shordie Shordie - Bonnie & Clyde
Kid Ink - Slide Up
Ludmilla - Verdinha
deadmau5 - FALL
Kilo Kish - SPARK
SYML - Take Me Apart
Aaron Carpenter - Proud
Blac Youngsta - Whisper (feat. City Girls)
The Cool Kids - Pop Quiz
SAINT PHNX - Scream
Alex Aiono - Be Alright Forever
ASHS - Paranoid
HappyBirthdayCalvin - Still Did It (4th of July)
Quando Rondo - Marvelous (feat. Polo G)
Griselda - Cruiser Weight Coke
Vistas - Teenage Blues
Billy Talent - Forgiveness I + II
Lily Moore - Better Than Me
Norah Jones - Playing Along (with Tarriona Tank Ball)
Regina Spektor - One Little Soldier
Arlo Parks - Paperbacks
ASL - Helium
G Herbo - Hunnit Bands
Nines - Pride
Jay Pryor - By Now
Bishu - Let You Down
Beoga - Make A Mark
Gerry Cinnamon - The Bonny
Lewis Watson - spark
Sarah Close - Almost
GALXARA - KILLA KILLA
Derek King - Sum
No Love For The Middle Child - You Know That
Mighty Oaks - Forget Tomorrow
Jack Peñate - Loaded Gun
Spencer Sutherland - Grateful
Anfa Rose - Casa
22Gz - Suburban, Pt. 2
Smoke Dza - Inhale
JØRD - Drunk
Habstrakt - Real
Superheart - Heaven's In Your Head
November Lights - Black and Blue
Catie Turner - i luv him.
Benji Lewis - New Day
Thomas Headon - Clean Me Up
Lilla Vargen - The Shore
Camp Claude - Dancing Alone