Mumford & Sons - Snake Eyes
Gin Wigmore - New Rush
Armin van Buuren feat. Mr. Probz - Another You
Panic! At The Disco - Hallelujah
Jeremih feat. Flo Rida - Tonight Belongs to U!
Major Lazer feat. Travi$ Scott, 2 Chainz, Pusha T & Mad Cobra - Night Riders
AURORA - Running With the Wolves
Jarryd James - Do You Remember
Giorgio Moroder feat. Sia - Déjà Vu
Jessie J - Flashlight
Allen Stone - Upside
Alabama Shakes - Shoegaze
Kopecky - Talk to Me
Northern Faces - Get Out the Way
Brand New - Mene
ISHi feat. Pusha T & CAZZETTE - Push It (CAZZETTE vs. iSHi Remix)
Galantis - Peanut Butter Jelly
Vic Mensa feat. Kanye West - U Mad
Dej Loaf feat. Lil Wayne - Me U & Hennessy
Dustin Kensrue - Gallows
Gang of Youths - Restraint & Release
Cheat Codes feat. Evan Gartner - Adventure
Passion Pit - My Brother Taught Me How to Swim
GRRL PAL - Radar
Osca - Smoke
San Fermin - Jackrabbit
SOAK - Blud
The Tallest Man On Earth - Dark Bird is Home
Night Beds - Tide Teeth
Leikeli47 feat. Biker Boy Pug - Fuck the Summer Up
Littlebabyangel - @Cartier
Air Traffic Controller - People Watching
Dylan Kelly - All My Friends
Urban Cone - Weekends
Unknown Mortal Orchestra - Can't Keep Checking My Phone
Blur - My Terracotta Heart
Ryan Adams - My Wrecking Ball (Live at Carnegie Hall)
The Weepies - Crooked Smile
Built to Spill - Never Be the Same
Great Lake Swimmers - Zero in the City
Natalie Imbruglia - Instant Crush
Girlpool - Before the World Was Big
Imagine Dragons - I Bet My Life (Live from Spotify London)
Jez Dior - The Line
Five Knives - Savages
Honeyhoney - You and I
Brett Eldredge - Lose My Mind
Turbo Fruits - Show Me Something Real
Johnny Marr - I Feel You
Alabama Shakes - Future People
HOLYCHILD - Money All Around
Findlay - Wolfback
Yelawolf - Change
Adam Lambert - Ghost Town
Clean Bandit - Stronger
ASTR - Activate Me
Ookay feat. Scott Singjin - Echo
Romeo Blanco feat. Brad Mair - We'll Be United
Jochen Miller feat. Hansen Tomas - A Million Pieces
Hudson Mohawke - Ryderz
Janelle Kroll - Sunny Days
KB feat. Lecrae - Sideways
O.T. Genasis - The Flyest
August Alsina - Hip Hop
Tyler, The Creator feat. Kanye West & Lil Wayne - SMUCKERS
Everydayz feat. Phazz - Almeria
AYER - In My Headphones