Post Malone - wow.
Bad Bunny, Diplo - 200 MPH
21 Savage - out for the night, part 2 (feat. Travis Scott)
Russ - Nobody Knows
Kina Grannis - When The Party's Over
Mark Ronson, Miley Cyrus - Nothing Breaks Like A Heart (Dimitri From Paris Remix)
Lily & Madeleine - Just Do It
24Hrs - Fitness (feat. Wiz Khalifa)
Nora Van Elken, Zack Gray - Missing You (Casp:r Remix)
Bad Bunny - Tenemos Que Hablar
Kvng Shad, Trippie Redd - Fuck The Other Side
Dej Loaf - Big Keys
Luke Christopher - MAKE YOU FORGET
Holy White Hounds - No Teeth
Ph4de, Kap G - Dont Say Much
As December Falls - On The Edge
bbno$, Y2K, Lewis Grant - Thankful
Annmarie - Secret (feat. YK Osiris)
Glasses Malone, J-Haze - So Official
Lil Bird - Truck Stop
Fangs, Holly T - Let's Get Weird
ANYA - These Days
Christian Rich, Yoshi Flower - in the morning
SayWeCanFly - Skully
Ruben - Lay By Me
Savoir Adore - When The Summer Ends (RAC Mix)
Geek, Zookeepers - Out Of Body
MÃ©lissa Vales - All In
BROHUG - Swag
Andrew Applepie, NKLS - Catch It
Hunter Powell - Lil Woke
Jonathan Maiocco - Us Against The World (feat. James Harris)
Cub Sport - Summer Lover
Alex Vargas - Now That I Think About It (Acoustic)
Ryan Oakes - Talking To Myself
Vijay & Sofia Zlatko - Breathe
Trey Schafer - Decapitated
Jamie Cullum - Ex Factor / Nice For What
HYLLS - Why
Robbie Williams - I Just Want People To Like Me
Bow Wow - Wish I Never Met Her
SRC, John Peaterson - Desert Rose
Yung Luv - Shotgun
Bijou Bijou - California Calls
BLVTH - Disarray
Davai, Call Me Loop - Cry Like Kim K (feat. Lisa Ajax)
Imaginary Future - We Are The Love We Give (Acoustic)
Austin Prince - Sadie
The Clay People - Colossus
Danny Bonilla - Dance With Me (feat. Tony Tone, Luna Luna)
Madson. - Go to Sleep (feat. Forrest.)
Khea - Screenshot
Palisades - Erase The Pain
D-Sol - Feel Alive (feat. Katt Rockell)