Stars Go Dim - Invisible
Danny Gokey - Fighter
Elevation Worship - Hallelujah Here Below (Paradoxology) (feat. Steffany Gretzinger)
Elle Limebear - Find Me At Your Feet
Cade Thompson - Voices
** The Gray Havens - Far Kingdom (reimagined)
Planetshakers - Only Way (Live)
Tommee Profitt - Gloria Regali (feat. Fleurie)
Ã˜M-53 - Set My Heart
Wande - Blessed Up
Ecclesia - Eyes Only For You (feat. Montell Fish)
for KING & COUNTRY - God Only Knows (Robin G. Acoustic Mix)
Lou Fellingham - Wonder of the Cross (Live)
Martin Smith - Iron Lung
Gloria Gaynor - Amazing Grace
Greg Kirkland Jr. - Give
Conrad - Never Let You Go
Francesca Battistelli - Defender (Single Version) (feat. Steffany Gretzinger)
Greg LaFollette - Psalm 31 (Into Your Hand) (feat. Sarah Kroger)
Wimberley - Better One
Embassy - Wrapped Up In Your Splendor
Lyle Larue - Measure (feat. Taylor Reed)
Valley Creek Worship - The One
Caves - Thank You for the Cross
Woodlands Worship - Maker
Sara Groves - To The Dawn
Caleb and Kelsey - Hymns Medley: Amazing Grace / Great Is Thy Faithfulness / Be Thou My Vision / Holy Holy Holy / I Need Thee Every Hour / It Is Well / How Great Thou Art
Kees Kraayenoord - Saviour's Song
Da Church, Marqus Anthony, Miraql3 - Treasure (feat. Lance Hitch)
James Fortune - I Am (Radio Edit) (feat. Deborah Carolina)
King Chav, Rab G - Sleight of Hand
Andrea Hamilton - All but Lost
** Nicole Serrano - My Victory (feat. Community Songs)
Linga TheBoss - Bless You
Kevin Winebarger - God of Resurrection
Son of Cloud - Parade
Erskin Anavitarte - Only Love
Before Their Eyes - Why 6 Is Afraid of 7
My Epic - Bloody Angles
Allan - Every Chain
Terrian - God With Us
Erica Bostick - Long for You
Will & Mim Johnson - Seasons
Hope Music - Offer My Heart (Nothing Is Wasted) (feat. Drew Daniels)
Landers Music Co. - Walls
Taylor Tripodi - Learning to Trust
Alanah Sabatini - Sun
Jessica Hitte - No Resistance (feat. Jonathan Ernstly Etienne)
Wild Earth - Creation Groans
Homegrown Worship - Enduring Love