Ed Sheeran - I Don't Care
James Arthur - Falling like the Stars
Avicii - Tough Love
David Guetta - Stay (Don't Go Away)
Grace Carter - Don't Hurt Like It Used To
FISHER - You Little Beauty
Major Lazer - Can't Take It From Me
ZAYN - A Whole New World
R3HAB - Don't Give Up On Me
teamwork - Afterhours
James Bay - bad
Carly Rae Jepson - Too Much
()
Madonna - Crave
Skepta - Greaze Mode
girl in red - dead girl in the pool.
SG Lewis - Flames
MK - Body 2 Body
Gorgon City - Go Slow
The Night Cafe - Please
Sam Feldt - Magnets
()
Charlie Cunningham - Bite
Rhye - Patience
Skepta - Bullet From A Gun
Aazar - Diva
Sea Girls - Damage Done
1000 Beasts - Sorry
()
CXLOE - Low Blow
AURORA - The River
()
Tom Zanetti - Wicked and Bad
Ingrid Michaelson - Missing You
Melis - Falling into Place
blink-182 - Blame It On My Youth
Isaac Dunbar - cologne
FELIX SANDMAN - Happy Thoughts
Franky Wah - Words - Radio Edit
()
Russ - Civil War
Kita Alexander - Between You & I
Gypsies on the Autobahn - Make You Mine
Jaded - Move It
Dan Owen - Run Me Down
üêö
Emotional Oranges - Good To Me
()
()
Bry - Why Are You bothering With Me?
The Amazons - End Of Wonder
Zuzu - How It Feels
()
WSTRN - Medusa
P Money - Where & When
üêö
Roo Panes - All These Walking Thoughts
Marques Martin - Dinner Date
üêö
Jonah Yano - nervous
()
()
Talia Storm - Soulmate
Rosie Lowe - Mango
()
Hannah Grace - Sleepwalking
Yung Pinch - Wink Emoji
()
()
Flying Lotus - More
üêö
()
Petr Cech - That's Football
]()
üêö
IDLES - Mercedes Marxist
()
()
Childcare - Sugarcane
ASAP Ferg - Pups
Holly Herndon - Frontier
()
()