Elle Limebear - Holding Me Still
Switchfoot - THE HARDEST ART (feat. Kaela Sinclair)
Doxamillion - Everyday (feat. GabrielRodriguezEMC, Ada Betsabe)
Jesus Culture - Freedom (Radio Version)
Corey Voss & Madison Street Worship - Praise Your Name (Live)
Rhett Walker Band - Peace in the Family (Remix) (feat. Propaganda, Soul Glow Activatur)
Sajan Nauriyal - Sight (feat. Proud Refuge, Shop√©)
Planetshakers - I Lift Your Name Up (Live)
Vertical Worship - Yes I Will (Studio Version)
Tobe Nwigwe - SHINE. (feat. Madeline Edwards)
PEABOD - Left Out (feat. Chad Mattson)
Trinity (NL) - Wherever We Go
Phil Wickham - Living Hope (House Sessions)
Ian Yates - Hope Beyond Hope
Dan Bremnes - Thunder
Atlas Rhoads - Nothing Can Tear
Dwain Walters - Crazy (feat. Monty G)
The Block Worship - Overflow
Jimi Cravity - Ultraviolet**
Lucy Grimble - Keeper (Eikon Remix)
Amanda Wanessa - Vida em Obras
Lavon Bibb - Better (feat. Alic Walls)
Leandro Borges - Templo Solar (I. Marte, II. Netuno, III. Marte Final)
Tinkez - No Problem (with Pierre)
Melancholy Moss - Don't Hurt
Lisa Knowles-Smith - Great Big God
Mondre & Divine - It's Gonna Get Better (feat. Lisa Knowles-Smith)
Miss Caffeina - Reina
Isaac Valdez - Verdero Amor
Man Of FAITH - Like That (Radio Edit)
Tyler Budke - Move On
King Solomon - Lemonade
Ecclesia - We Could Be The Ones
Stan Whitmire - Jesus Is The Sweetest Name I Know / His Name Is Wonderful / Oh, How I Love Jesus - Medley
Jodie Jermaine, Psyonik - Diffrnt This Time
Black - Caught Between (feat. Jaeshaun Tays)
Ryza Martinez, Jeffery Ray C. Miguel - The Lord Steadfast Love (Based on Psalm 118)
Danilo Montero - Cuando la Iglesia Ora en Vivo
JXHN PVUL - Embrace
Homegrown Worship - Restoring Waters
Jordan Feliz - Changed (Live)
Daniel Baciu - Soaring Lights
Phil Wickham - How Great Is Your Love (House Sessions)**
Laity - Ineedyou
rocdomz - Highest Form of Flattery
Kyle Travis - I'm Sorry
Ghost Ship - You
Casey J - 1,000 Hallelujahs
Nathan Pacheco - May It Be
Becca Bradley - Nothing Short of a Miracle
Will Morrison - You Say (Acoustic)